NO ./asset/CRATE_2D.xpm
EA ./asset/CRATE_2G.xpm
SO ./asset/CRATE_2A.xpm
WE ./asset/CRATE_2L.xpm
F 50,50,50
C 200,200,200

11111111111111111111
10001000000000001001
10001000N00000001001
10011011001010111001
10000000100000000001
10000000100000001001
10000000110000001001
10001000100000001001
10001000000001111001
11111000000001000001
10000000000001000001
11111111111111111111
