F 50,50,50
C 200,200,0
SO ./asset/CRATE_2A.xpm
NO ./asset/CRATE_2D.xpm
EA ./asset/CRATE_2G.xpm
WE ./asset/CRATE_2L.xpm

1111111111111111111111
1000100000000000100001
10001000N0000000100001
1001101100101011100001

1111111111111111111111
