F 50,50,50
EA ./asset/CRATE_2G.xpm
C 200,200,0
WE ./asset/CRATE_2L.xpm
NO ./asset/CRATE_2D.xpm
SO ./asset/CRATE_2A.xpm

11111111111111111111
10001000000000001001
10001000N00000001001
10011011000000100001
10000000100001000001
10000000100000001001
10000000110001001001
10001000100000101001
10001000000001111001
11111000000001000001
10000000000001000001
11111111111111111111
