          1
         1S1
        10001
       1000001
      100000001
       1000001
        10001
         101
          1 